111111111111111111111111111100111111110000111111110402004011110125211011110402004011111111111111111111111111111111111111111111111111111111111111
111111111111111111111111110111111111115000011111110120401111110104341111110120422001110000000011111011001111111111111111111111111111111111111111
111111111111111000001111111000001111111005001111111002001111111000001111111004001111111000001111111000001111111000001111111000001111111111111111
111001111111111400111111111400111111111101111111110000014111000121010111005000010111101100110111101110110111100020200111100111100111111111111111
111111111111111111111111111111111111111111111111111111150111111111122111111111400111111140014111111100000011111110121011111114002011111111111111
111111111111111111111111111111111111111141402011111151110011111020103011111002242411111004002011111111114011111111111111111111111111111111111111
111111111111114111111111110003010011110101010111110020000011110100000011110001111011111001141011110101102011110001105011111111111111111111111111
300000000000000000000000000000000000000000000000000000000000000000000000000000000000000000000000000000000000000000000000000000000000000000000000
120000000000000000000000000000000000000000000000000000000000000000000000000000000000000000000000000000000000000000000000000000000000000000000000
111111111111111140000111111111010111111111010111111111010111141102520111101100011111100201011111101111011111101111011111100000041111111111111111
